720 432 24
348 284 0
-1 -1 -1 -1 -1 -1 -1 -1 -1 -1 -1 -1 -1 -1 -1 -1 -1 -1 -1 -1 -1 -1 -1 -1 -1 -1 -1 -1 -1 -1
-1 -1 -1 -1 -1 -1 -1 -1 -1 -1 -1 -1 -1 -1 -1 -1 -1 -1 -1 -1 -1 -1 -1 -1 -1 -1 -1 -1 -1 -1
-1 -1 -1 -1 -1 -1 -1 -1 -1 -1 -1 -1 -1 -1 -1 -1 -1 -1 -1 -1 -1 -1 -1 -1 -1 -1 -1 -1 -1 -1
-1 -1 -1 -1 -1 -1 -1 -1 -1 -1 -1 -1 -1 -1 -1 -1 -1 -1 -1 -1 -1 -1 -1 -1 -1 -1 -1 -1 -1 -1
-1 -1 -1 -1 00 00 00 00 00 00 00 00 00 00 00 00 00 00 00 00 00 00 00 00 00 00 -1 -1 -1 -1
-1 -1 -1 -1 00 00 -1 -1 -1 -1 -1 -1 00 -1 -1 -1 -1 00 -1 -1 -1 -1 -1 -1 00 00 -1 -1 -1 -1
-1 -1 -1 -1 00 -1 00 -1 -1 -1 00 -1 00 00 00 00 00 00 -1 -1 -1 -1 -1 -1 -1 00 -1 -1 -1 -1
-1 -1 -1 -1 00 -1 -1 -1 -1 -1 -1 -1 -1 -1 -1 -1 -1 -1 -1 -1 -1 -1 -1 -1 -1 00 -1 -1 -1 -1
-1 -1 -1 -1 00 -1 -1 -1 -1 -1 -1 -1 -1 -1 -1 -1 -1 -1 -1 -1 -1 -1 -1 -1 -1 00 -1 -1 -1 -1
-1 -1 -1 -1 00 -1 -1 -1 -1 -1 -1 -1 00 -1 -1 -1 -1 00 -1 -1 -1 -1 -1 -1 -1 00 -1 -1 -1 -1
-1 -1 -1 -1 00 -1 00 -1 -1 -1 00 -1 00 -1 -1 -1 -1 00 -1 -1 -1 -1 -1 -1 -1 00 -1 -1 -1 -1
-1 -1 -1 -1 00 -1 -1 -1 -1 -1 -1 -1 00 -1 -1 00 -1 00 -1 -1 -1 -1 -1 -1 -1 00 -1 -1 -1 -1
-1 -1 -1 -1 00 00 00 00 00 00 00 00 00 00 -1 00 00 00 00 00 00 00 00 00 00 00 -1 -1 -1 -1
-1 -1 -1 -1 -1 -1 -1 -1 -1 -1 -1 -1 -1 -1 02 -1 -1 -1 -1 -1 -1 -1 -1 -1 -1 -1 -1 -1 -1 -1
-1 -1 -1 -1 -1 -1 -1 -1 -1 -1 -1 -1 -1 -1 -1 -1 -1 -1 -1 -1 -1 -1 -1 -1 -1 -1 -1 -1 -1 -1
-1 -1 -1 -1 -1 -1 -1 -1 -1 -1 -1 -1 -1 -1 -1 -1 -1 -1 -1 -1 -1 -1 -1 -1 -1 -1 -1 -1 -1 -1
-1 -1 -1 -1 -1 -1 -1 -1 -1 -1 -1 -1 -1 -1 -1 -1 -1 -1 -1 -1 -1 -1 -1 -1 -1 -1 -1 -1 -1 -1
-1 -1 -1 -1 -1 -1 -1 -1 -1 -1 -1 -1 -1 -1 -1 -1 -1 -1 -1 -1 -1 -1 -1 -1 -1 -1 -1 -1 -1 -1
